12 88 18 5 90 40
0 1 2 0 0 1 2 0 0 1 3 0 0 1 2 0 4 1 2 4 0 0 0 0 1 2 5 1 6 0 0 4 1 4 1 4 1 4 1 0 4 0 6 6 0 5 1 7 8 9 9 1 9 9 9 9 10 9 10 9 9 9 9 11 0 0 1 6 0 1 4 0 1 2 12 13 0 14 1 13 0 14 1 13 0 3 4 7
15 16 17 18 19 16 17 18 19 16 20 18 19 16 17 18 15 16 17 21 19 19 19 19 16 22 21 16 19 19 19 15 16 21 16 21 16 21 16 19 21 19 19 19 19 21 16 23 24 25 26 27 26 28 28 28 27 25 16 26 26 28 28 23 19 15 16 19 19 16 21 19 16 17 15 19 29 30 16 31 29 30 16 31 29 20 21 32
19 16 22 21 19 16 17 21 19 16 17 21 19 16 17 21 19 16 17 21 19 19 33 34 35 36 37 37 38 39 19 19 16 21 16 21 16 21 16 18 21 19 33 34 37 36 35 40 41 42 42 35 26 26 43 43 16 43 16 26 25 42 42 40 36 37 37 38 39 16 21 19 16 22 19 19 16 19 16 19 16 19 16 18 16 22 21 23
19 16 19 21 19 16 22 21 18 16 17 21 19 16 22 21 19 16 17 21 33 34 44 45 16 19 15 16 46 47 36 37 16 21 16 21 16 21 16 15 21 33 48 45 19 19 29 32 24 43 43 16 42 49 50 43 74 74 51 42 49 50 25 52 20 19 29 46 47 37 36 37 37 38 39 19 16 19 16 19 16 19 16 15 16 33 34 40
19 16 19 21 18 16 19 21 15 16 22 21 19 16 19 21 15 16 22 33 48 45 18 19 16 19 19 16 19 16 18 18 16 21 16 21 16 21 16 18 33 48 45 18 19 19 16 32 24 26 26 27 43 16 53 50 75 74 27 43 16 53 50 52 22 19 16 19 18 16 15 16 15 46 54 39 16 19 16 19 16 19 16 19 16 44 45 32
36 35 36 36 36 35 36 36 36 35 36 36 36 35 36 36 36 35 36 44 36 36 36 36 35 36 36 35 36 35 36 36 35 36 35 36 35 36 35 36 44 36 36 36 36 36 35 55 41 56 42 35 42 35 57 58 76 74 35 49 35 57 58 59 36 36 35 36 36 35 36 35 36 36 36 47 35 36 35 36 35 36 35 36 35 36 36 55
11 11 11 11 11 11 11 11 11 11 11 11 11 11 11 11 11 11 11 11 11 11 11 11 11 11 11 11 11 11 11 11 11 11 11 11 11 11 11 11 11 11 11 11 11 11 11 11 51 60 61 51 11 11 51 11 51 11 1 60 61 11 1 62 11 11 11 11 11 11 11 11 11 11 11 11 11 11 11 11 11 11 11 11 11 11 11 11
11 11 11 11 11 11 11 11 11 11 11 11 11 11 11 11 11 11 11 11 11 11 11 11 11 11 11 11 11 11 11 11 11 11 11 11 11 11 11 11 11 11 11 11 11 11 11 11 16 26 63 27 11 11 27 11 16 11 16 26 63 61 16 52 11 11 11 11 11 11 11 11 11 11 11 11 11 11 11 11 11 11 11 11 11 11 11 11
11 11 11 11 11 11 11 11 11 11 11 11 11 11 11 11 11 11 11 11 11 11 11 11 11 11 11 11 11 11 11 11 11 11 11 11 11 11 11 11 11 11 11 11 11 11 11 11 27 26 26 64 11 11 27 11 16 11 16 26 26 63 16 52 11 11 11 11 11 11 11 11 11 11 11 11 11 11 11 11 11 11 11 11 11 11 11 11
11 11 11 11 11 11 11 11 11 11 11 11 11 11 11 11 11 11 11 11 11 11 11 11 11 11 11 11 11 11 11 11 11 11 11 11 11 11 11 11 11 11 11 11 11 11 11 11 51 65 65 51 66 65 51 11 51 11 51 65 65 65 67 52 11 11 11 11 11 11 11 11 11 11 11 11 11 11 11 11 11 11 11 11 11 11 11 11
11 11 11 11 11 11 11 11 11 11 11 11 11 11 11 11 11 11 11 11 11 11 11 11 11 11 11 11 11 11 11 11 11 11 11 11 11 11 11 11 11 11 11 11 11 11 11 11 27 11 11 27 68 69 16 70 16 70 16 69 70 11 16 65 11 11 11 11 11 11 11 11 11 11 11 11 11 11 11 11 11 11 11 11 11 11 11 11
11 11 11 11 11 11 11 11 11 11 11 11 11 11 11 11 11 11 11 11 11 11 11 11 11 11 11 11 11 11 11 11 11 11 11 11 11 11 11 11 11 11 11 11 11 11 11 11 71 71 71 71 71 71 71 71 71 71 71 71 71 71 51 71 11 11 11 11 11 11 11 11 11 11 11 11 11 11 11 11 11 11 11 11 11 11 11 11
