63
1 21 -1 0 390 3168 32 2
2 43 -1 55 330 0 0 0 
3 43 -1 180 265 0 0 0 
4 43 -1 310 330 0 0 0 
5 43 -1 440 265 0 0 0 
6 43 -1 565 330 0 0 0 
7 43 -1 700 265 0 0 0 
8 43 -1 820 330 0 0 0 
9 43 -1 950 265 0 0 0 
10 43 -1 1080 330 0 0 0 
11 43 -1 1205 265 0 0 0  
12 43 -1 1335 140 0 0 0 
13 43 -1 1715 140 0 0 0 
14 43 -1 1850 330 0 0 0  
15 43 -1 1975 140 0 0 0  
16 43 -1 2100 330 0 0 0 
17 43 -1 2230 330 0 0 0 
18 43 -1 2355 330 0 0 0 
19 43 -1 2480 330 0 0 0  
20 43 -1 2605 330 0 0 0 
21 43 -1 2735 260 0 0 0  
22 43 -1 2870 140 0 0 0 
23 43 -1 3005 80 0 0 0  
24 43 -1 3245 140 0 0 0 
25 43 -1 3375 110 0 0 0 
26 43 -1 3125 335 0 0 0 
27 43 -1 3505 270 0 0 0 
28 21 -1 1376 265 96 32 2 
29 21 -1 1505 200 320 32 2 
30 21 -1 1855 265 192 32 2 
31 21 -1 2785 200 544 32 2 
32 21 -1 3200 390 384 32 2 
33 21 -1 3330 265 96 32 2 

34 21 -1 3585 390 128 32 3

35 21 -1 3585 326 16 16 3
36 21 -1 3585 342 16 16 3
37 21 -1 3585 358 16 16 3
38 21 -1 3585 374 16 16 3

39 21 -1 3601 326 16 16 3

40 21 -1 3601 342 16 16 3
41 21 -1 3601 358 16 16 3

42 21 -1 3617 230 48 160 3
43 21 -1 3585 230 16 96 3

44 21 -1 3601 262 16 48 3
45 21 -1 3601 230 16 16 3


46 21 -1 3665 326 16 16 3
47 21 -1 3665 342 16 16 3
48 21 -1 3665 358 16 16 3
49 21 -1 3665 262 16 48 3
50 21 -1 3665 230 16 16 3

51 21 -1 3681 230 32 160 3

52 21 -1 3713 230 64 32 2
53 21 -1 3713 390 96 32 2

54 47 1 1248 389 0 0 0
55 48 1 1377 204 0 0 0
 
56 47 1 2594 389 0 0 0
57 48 1 2786 140 0 0 0


58 47 -1 3542 387 0 0 0
59 48 -1 3413 202 0 0 0
 
 
60 47 1 1441 264 0 0 0
61 48 1 1506 139 0 0 0
 

62 47 -1 1880 263 0 0 0
63 48 -1 1815 141 0 0 0
 

[MOUSE POSITION] 1823 141 
[MOUSE POSITION] 1884 263 



























59
1 21 -1 0 390 3168 32 2
2 43 -1 55 330 0 0 0 
3 43 -1 180 265 0 0 0 
4 43 -1 310 330 0 0 0 
5 43 -1 440 265 0 0 0 
6 43 -1 565 330 0 0 0 
7 43 -1 700 265 0 0 0 
8 43 -1 820 330 0 0 0 
9 43 -1 950 265 0 0 0 
10 43 -1 1080 330 0 0 0 
11 43 -1 1205 265 0 0 0  
12 43 -1 1335 140 0 0 0 
13 43 -1 1715 140 0 0 0 
14 43 -1 1850 330 0 0 0  
15 43 -1 1975 140 0 0 0  
16 43 -1 2100 330 0 0 0 
17 43 -1 2230 330 0 0 0 
18 43 -1 2355 330 0 0 0 
19 43 -1 2480 330 0 0 0  
20 43 -1 2605 330 0 0 0 
21 43 -1 2735 260 0 0 0  
22 43 -1 2870 140 0 0 0 
23 43 -1 3005 80 0 0 0  
24 43 -1 3245 140 0 0 0 
25 43 -1 3375 110 0 0 0 
26 43 -1 3125 335 0 0 0 
27 43 -1 3505 270 0 0 0 
28 21 -1 1374 265 96 32 2 
29 21 -1 1505 200 320 32 2 
30 21 -1 1855 265 192 32 2 
31 21 -1 2785 200 544 32 2 
32 21 -1 3200 390 384 32 2 
33 21 -1 3330 265 96 32 2 

34 21 -1 3585 390 128 32 3

35 21 -1 3585 326 16 16 3
36 21 -1 3585 342 16 16 3
37 21 -1 3585 358 16 16 3
38 21 -1 3585 374 16 16 3

39 21 -1 3601 326 16 16 3

40 21 -1 3601 342 16 16 3
41 21 -1 3601 358 16 16 3

42 21 -1 3617 230 48 160 3
43 21 -1 3585 230 16 96 3

44 21 -1 3601 262 16 48 3
45 21 -1 3601 230 16 16 3


46 21 -1 3665 326 16 16 3
47 21 -1 3665 342 16 16 3
48 21 -1 3665 358 16 16 3
49 21 -1 3665 262 16 48 3
50 21 -1 3665 230 16 16 3

51 21 -1 3681 230 32 160 3

52 21 -1 3713 230 64 32 2
53 21 -1 3713 390 96 32 2

54 44 1 1250 380 50 20 1 
55 46 1 1370 185 32 20 1


56 44 1 2595 380 50 20 1 
57 46 1 2776 128 32 10 1

58 44 -1 3542 380 50 20 1 
59 46 -1 3400 193 32 10 1



// 44 là cầu thang, model 1 là ở dưới

// id 35-38 phần Brick đánh vào sẽ ra item


//1 21 -1 0 390 5632 32 2


//21 nền
//43 cây nến