89
1 21 -1 -320 390 3488 32 2
2 43 -1 55 330 0 0 0 
3 43 -1 180 265 0 0 0 
4 43 -1 310 330 0 0 0 
5 43 -1 440 265 0 0 0 
6 43 -1 565 330 0 0 0 
7 43 -1 700 265 0 0 0 
8 43 -1 820 330 0 0 0 
9 43 -1 950 265 0 0 0 
10 43 -1 1080 330 0 0 0 
11 43 -1 1205 265 0 0 0  
12 43 -1 1335 140 0 0 0 
13 43 -1 1715 140 0 0 0 
14 43 -1 1850 330 0 0 0  
15 43 -1 1975 140 0 0 0  
16 43 -1 2100 330 0 0 0 
17 43 -1 2230 330 0 0 0 
18 43 -1 2355 330 0 0 0 
19 43 -1 2480 330 0 0 0  
20 43 -1 2605 330 0 0 0 
21 43 -1 2735 260 0 0 0  
22 43 -1 2870 140 0 0 0 
23 43 -1 3005 80 0 0 0  
24 43 -1 3245 140 0 0 0 
25 43 -1 3375 110 0 0 0 
26 43 -1 3125 335 0 0 0 
27 43 -1 3505 270 0 0 0 
28 21 -1 1376 265 96 32 2 
29 21 -1 1505 200 320 32 2 
30 21 -1 1855 265 160 32 2 
31 21 -1 2785 200 544 32 2 
32 21 -1 3200 390 384 32 2 
33 21 -1 3330 265 96 32 2
34 21 -1 3057 230 32 160 3
35 21 -1 3057 80 32 32 3
36 21 -1 3585 229 32 96 4
37 21 -1 3618 229 96 160 4
38 21 -1 3585 390 132 32 4
39 21 -1 3585 328 32 32 6
40 21 -1 3585 360 32 32 5
41 42 -1 3190 423 40 10 0
42 21 -1 2912 617 608 32 2
43 21 -1 3265 553 64 32 2
44 47 -1 3255 549 0 0 0

46 21 -1 3584 615 64 32 2
47 21 -1 3713 615 288 32 2
48 21 -1 4079 456 16 224 3
49 21 -1 4032 681 64 32 2
50 21 -1 3967 744 64 32 2
51 21 -1 4001 615 32 32 2

52 21 -1 3713 229 64 32 2

53 21 -1 3713 390 96 32 2
54 47 1 1248 389 0 0 0
55 48 1 1377 204 0 0 0
56 47 1 2594 389 0 0 0
57 48 1 2786 140 0 0 0
58 47 -1 3542 387 0 0 0
59 48 -1 3413 202 0 0 0
60 47 1 1441 264 0 0 0
61 48 1 1506 139 0 0 0
62 47 -1 1880 263 0 0 0
63 48 -1 1815 141 0 0 0
64 26 -1 3054 105 0 0 0 
65 42 -1 3985 709 40 40 0
66 42 -1 3460 770 504 30 0
67 42 -1 3180 100 100 100 0
68 21 -1 3426 265 32 32 4
69 48 -1 3158 337 0 0 0
70 21 -1 3168 390 32 32 4
71 43 -1 1595 91 0 0 0 
72 21 -1 2015 265 32 32 2

73 43 -1 3121 490 0 0 0 
74 43 -1 3254 490 0 0 0 
80 43 -1 3382 490 0 0 0
75 43 -1 3505 490 0 0 0 
76 43 -1 3636 490 0 0 0 
77 43 -1 3760 490 0 0 0 
78 43 -1 3881 490 0 0 0 
79 43 -1 4017 490 0 0 0 
 

81 42 -1 3807 460 30 20 0

82 47 -1 3960 615 0 0 0
83 48 -1 3797 330 0 0 0

84 21 -1 3809 390 32 32 4
85 21 -1 3841 390 6400 32 2


86 21 -1 3776 263 96 32 2
87 21 -1 3872 263 32 32 4

88 47 -1 3992 390 0 0 0
89 48 -1 3866 208 0 0 0

90 21 -1 3903 198 192 32 2


 

cầu thang 47 48
id 45: object ẩn -> trở lên trước khi xuống hồ nước -> tự sinh ra
id 71: Holy Water

id 72: brick -> a bonus

id 39: brick 4 ô -> chỉ effect
id 40: brick 3 ô ->Pot Roast
id 41: object ẩn -> xuống hồ nước
 
id 51: brick 2 -> effect
id 65: object ẩn -> bonus
id 66: object ẩn -> chạm nước -> chết
id 67: object ẩn -> box xác nhận simon đã qua cửa


// id 81: object ẩn -> ra khỏi hồ nước phía phải
id 86: object ẩn -> vào hồ nước phía phải


// id 64, type 26 Object ẩn dùng để mở cửa 

