0 0 0 4096 1536 1 0 
1 0 0 2048 768 1 0 
2 2048 0 2048 768 1 0 
3 0 768 2048 768 1 0 
4 2048 768 2048 768 1 0 
5 0 0 1024 384 0 1 172 
6 1024 0 1024 384 0 2 154 172 
7 0 384 1024 384 0 3 172 174 177 
8 1024 384 1024 384 1 0 
9 2048 0 1024 384 0 2 154 155 
10 3072 0 1024 384 1 0 
11 2048 384 1024 384 1 0 
12 3072 384 1024 384 1 0 
13 0 768 1024 384 1 0 
14 1024 768 1024 384 1 0 
15 0 1152 1024 384 1 0 
16 1024 1152 1024 384 1 0 
17 2048 768 1024 384 1 0 
18 3072 768 1024 384 1 0 
19 2048 1152 1024 384 0 0 
20 3072 1152 1024 384 0 0 
33 1024 384 512 192 0 3 172 174 177 
34 1536 384 512 192 0 4 154 156 174 177 
35 1024 576 512 192 0 4 171 172 174 177 
36 1536 576 512 192 1 0 
41 3072 0 512 192 0 1 155 
42 3584 0 512 192 1 0 
43 3072 192 512 192 0 1 155 
44 3584 192 512 192 1 0 
45 2048 384 512 192 0 3 154 155 192 
46 2560 384 512 192 0 3 155 159 192 
47 2048 576 512 192 1 0 
48 2560 576 512 192 1 0 
49 3072 384 512 192 1 0 
50 3584 384 512 192 1 0 
51 3072 576 512 192 1 0 
52 3584 576 512 192 1 0 
53 0 768 512 192 1 0 
54 512 768 512 192 1 0 
55 0 960 512 192 1 0 
56 512 960 512 192 1 0 
57 1024 768 512 192 1 0 
58 1536 768 512 192 1 0 
59 1024 960 512 192 1 0 
60 1536 960 512 192 1 0 
61 0 1152 512 192 1 0 
62 512 1152 512 192 0 4 129 128 127 186 
63 0 1344 512 192 0 1 187 
64 512 1344 512 192 0 3 129 128 127 
65 1024 1152 512 192 1 0 
66 1536 1152 512 192 0 2 182 185 
67 1024 1344 512 192 0 4 124 125 126 183 
68 1536 1344 512 192 0 1 183 
69 2048 768 512 192 1 0 
70 2560 768 512 192 1 0 
71 2048 960 512 192 1 0 
72 2560 960 512 192 1 0 
73 3072 768 512 192 0 4 192 190 180 179 
74 3584 768 512 192 0 0 
75 3072 960 512 192 0 3 190 181 180 
76 3584 960 512 192 0 0 
145 1536 576 256 96 1 0 
146 1792 576 256 96 0 3 62 96 154 
147 1536 672 256 96 1 0 
148 1792 672 256 96 0 2 62 96 
169 3584 0 256 96 1 0 
170 3840 0 256 96 1 0 
171 3584 96 256 96 0 4 48 78 138 142 
172 3840 96 256 96 1 0 
177 3584 192 256 96 1 0 
178 3840 192 256 96 0 4 54 80 135 142 
179 3584 288 256 96 1 0 
180 3840 288 256 96 0 3 9 8 135 
189 2048 576 256 96 1 0 
190 2304 576 256 96 0 2 155 192 
191 2048 672 256 96 0 3 68 94 161 
192 2304 672 256 96 1 0 
193 2560 576 256 96 0 2 155 192 
194 2816 576 256 96 0 3 155 159 192 
195 2560 672 256 96 0 4 91 90 65 192 
196 2816 672 256 96 0 2 89 192 
197 3072 384 256 96 0 2 155 159 
198 3328 384 256 96 0 2 144 153 
199 3072 480 256 96 1 0 
200 3328 480 256 96 0 4 152 150 144 153 
201 3584 384 256 96 0 3 9 144 145 
202 3840 384 256 96 1 0 
203 3584 480 256 96 1 0 
204 3840 480 256 96 1 0 
205 3072 576 256 96 1 0 
206 3328 576 256 96 1 0 
207 3072 672 256 96 0 4 51 88 192 193 
208 3328 672 256 96 0 2 86 87 
209 3584 576 256 96 1 0 
210 3840 576 256 96 0 4 137 82 146 151 
211 3584 672 256 96 0 1 84 
212 3840 672 256 96 0 2 137 83 
213 0 768 256 96 0 2 167 172 
214 256 768 256 96 0 2 172 186 
215 0 864 256 96 0 1 172 
216 256 864 256 96 1 0 
217 512 768 256 96 0 4 172 75 177 186 
218 768 768 256 96 1 0 
219 512 864 256 96 0 4 172 119 177 186 
220 768 864 256 96 1 0 
221 0 960 256 96 0 3 77 168 184 
222 256 960 256 96 1 0 
223 0 1056 256 96 0 3 77 168 184 
224 256 1056 256 96 0 3 73 184 186 
225 512 960 256 96 0 4 45 176 177 186 
226 768 960 256 96 1 0 
227 512 1056 256 96 0 3 74 177 186 
228 768 1056 256 96 0 3 76 177 186 
229 1024 768 256 96 1 0 
230 1280 768 256 96 1 0 
231 1024 864 256 96 1 0 
232 1280 864 256 96 1 0 
233 1536 768 256 96 1 0 
234 1792 768 256 96 0 4 162 163 164 166 
235 1536 864 256 96 0 4 166 169 171 177 
236 1792 864 256 96 0 4 98 97 164 166 
237 1024 960 256 96 0 4 76 28 177 186 
238 1280 960 256 96 0 4 28 13 177 186 
239 1024 1056 256 96 1 0 
240 1280 1056 256 96 1 0 
241 1536 960 256 96 0 4 166 113 58 177 
242 1792 960 256 96 0 1 166 
243 1536 1056 256 96 0 4 112 177 182 194 
244 1792 1056 256 96 0 1 111 
245 0 1152 256 96 0 1 184 
246 256 1152 256 96 0 3 186 184 132 
247 0 1248 256 96 0 3 184 130 131 
248 256 1248 256 96 0 4 186 184 132 131 
261 1024 1152 256 96 0 1 186 
262 1280 1152 256 96 1 0 
263 1024 1248 256 96 0 2 125 186 
264 1280 1248 256 96 0 3 33 185 186 
277 2048 768 256 96 0 3 164 165 166 
278 2304 768 256 96 0 2 165 192 
279 2048 864 256 96 1 0 
280 2304 864 256 96 1 0 
281 2560 768 256 96 0 1 192 
282 2816 768 256 96 0 3 179 190 192 
283 2560 864 256 96 1 0 
284 2816 864 256 96 1 0 
285 2048 960 256 96 1 0 
286 2304 960 256 96 1 0 
287 2048 1056 256 96 0 3 108 109 110 
288 2304 1056 256 96 0 2 107 108 
289 2560 960 256 96 1 0 
290 2816 960 256 96 1 0 
291 2560 1056 256 96 0 3 102 106 178 
292 2816 1056 256 96 0 3 103 178 181 
581 1536 576 128 48 0 6 156 154 157 160 174 177 
582 1664 576 128 48 0 2 154 160 
583 1536 624 128 48 0 8 154 25 26 52 157 160 174 177 
584 1664 624 128 48 0 2 154 160 
589 1536 672 128 48 0 7 158 2 25 26 160 174 177 
590 1664 672 128 48 0 3 95 2 160 
591 1536 720 128 48 0 5 158 2 171 174 177 
592 1664 720 128 48 0 1 2 
677 3584 0 128 48 0 1 133 
678 3712 0 128 48 0 3 133 21 23 
679 3584 48 128 48 0 2 142 48 
680 3712 48 128 48 0 2 142 21 
681 3840 0 128 48 0 2 133 21 
682 3968 0 128 48 0 1 133 
683 3840 48 128 48 0 4 20 21 22 142 
684 3968 48 128 48 0 2 134 141 
689 3840 96 128 48 0 6 79 30 19 20 140 142 
690 3968 96 128 48 0 3 134 140 141 
691 3840 144 128 48 0 4 30 19 140 142 
692 3968 144 128 48 0 2 140 141 
709 3584 192 128 48 0 6 55 24 59 138 139 142 
710 3712 192 128 48 0 5 24 5 59 60 142 
711 3584 240 128 48 0 3 55 59 139 
712 3712 240 128 48 0 6 5 6 7 59 60 81 
717 3584 288 128 48 0 1 143 
718 3712 288 128 48 0 3 81 7 8 
719 3584 336 128 48 0 1 143 
720 3712 336 128 48 0 2 8 9 
757 2048 576 128 48 0 1 154 
758 2176 576 128 48 0 1 155 
759 2048 624 128 48 0 4 161 154 94 53 
760 2176 624 128 48 0 2 161 155 
769 2304 672 128 48 0 3 192 93 67 
770 2432 672 128 48 0 3 192 66 92 
771 2304 720 128 48 0 1 192 
772 2432 720 128 48 0 1 192 
797 3072 480 128 48 0 3 159 155 192 
798 3200 480 128 48 0 1 147 
799 3072 528 128 48 0 4 159 155 34 192 
800 3200 528 128 48 0 3 34 147 152 
809 3840 384 128 48 0 3 10 9 145 
810 3968 384 128 48 0 1 136 
811 3840 432 128 48 0 4 12 11 10 145 
812 3968 432 128 48 0 1 136 
813 3584 480 128 48 0 4 144 49 148 150 
814 3712 480 128 48 0 6 145 61 50 146 148 151 
815 3584 528 128 48 0 3 144 148 150 
816 3712 528 128 48 0 4 61 146 148 151 
817 3840 480 128 48 0 6 145 29 18 12 146 151 
818 3968 480 128 48 0 5 136 29 18 149 151 
819 3840 528 128 48 0 4 29 18 146 151 
820 3968 528 128 48 0 4 29 18 149 151 
821 3072 576 128 48 0 5 34 36 155 159 192 
822 3200 576 128 48 0 3 152 34 35 
823 3072 624 128 48 0 3 51 155 192 
824 3200 624 128 48 0 1 152 
825 3328 576 128 48 0 2 152 153 
826 3456 576 128 48 0 2 150 144 
827 3328 624 128 48 0 2 152 87 
828 3456 624 128 48 0 1 86 
837 3584 576 128 48 0 3 150 144 85 
838 3712 576 128 48 0 3 151 146 85 
839 3584 624 128 48 0 1 85 
840 3712 624 128 48 0 1 85 
865 256 864 128 48 0 4 27 0 170 172 
866 384 864 128 48 0 2 172 186 
867 256 912 128 48 0 4 32 1 0 170 
868 384 912 128 48 0 5 32 1 121 175 186 
873 768 768 128 48 0 3 186 177 172 
874 896 768 128 48 0 5 186 177 174 173 172 
875 768 816 128 48 0 3 186 177 172 
876 896 816 128 48 0 5 186 177 174 173 172 
881 768 864 128 48 0 3 186 177 172 
882 896 864 128 48 0 3 186 177 172 
883 768 912 128 48 0 3 186 177 118 
884 896 912 128 48 0 3 186 177 117 
889 256 960 128 48 0 3 32 1 120 
890 384 960 128 48 0 5 175 32 1 176 186 
891 256 1008 128 48 0 1 184 
892 384 1008 128 48 0 4 73 176 184 186 
905 768 960 128 48 0 3 186 177 46 
906 896 960 128 48 0 3 186 177 47 
907 768 1008 128 48 0 3 186 177 46 
908 896 1008 128 48 0 4 186 177 47 76 
917 1024 768 128 48 0 5 186 177 174 173 172 
918 1152 768 128 48 0 3 186 177 174 
919 1024 816 128 48 0 5 186 177 174 173 172 
920 1152 816 128 48 0 3 186 177 174 
921 1280 768 128 48 0 4 186 177 174 171 
922 1408 768 128 48 0 5 186 177 174 169 171 
923 1280 816 128 48 0 4 186 177 174 171 
924 1408 816 128 48 0 5 186 177 174 169 171 
925 1024 864 128 48 0 4 186 177 172 116 
926 1152 864 128 48 0 3 186 177 115 
927 1024 912 128 48 0 3 186 177 116 
928 1152 912 128 48 0 3 186 177 115 
929 1280 864 128 48 0 4 186 177 114 171 
930 1408 864 128 48 0 4 186 177 169 171 
931 1280 912 128 48 0 4 186 177 114 171 
932 1408 912 128 48 0 4 186 177 169 171 
933 1536 768 128 48 0 5 3 169 171 174 177 
934 1664 768 128 48 0 6 166 162 4 3 31 169 
935 1536 816 128 48 0 4 169 171 174 177 
936 1664 816 128 48 0 5 166 162 4 31 169 
957 1024 1056 128 48 0 4 177 122 76 186 
958 1152 1056 128 48 0 4 177 123 28 186 
959 1024 1104 128 48 0 2 122 186 
960 1152 1104 128 48 0 2 123 186 
961 1280 1056 128 48 0 5 177 14 13 28 186 
962 1408 1056 128 48 0 2 177 186 
963 1280 1104 128 48 0 3 17 14 186 
964 1408 1104 128 48 0 2 182 186 
1049 1280 1152 128 48 0 3 17 16 186 
1050 1408 1152 128 48 0 3 182 185 186 
1051 1280 1200 128 48 0 4 33 16 15 186 
1052 1408 1200 128 48 0 5 182 33 15 185 186 
1117 2048 864 128 48 0 3 69 164 166 
1118 2176 864 128 48 0 2 70 165 
1119 2048 912 128 48 0 6 69 41 42 43 99 166 
1120 2176 912 128 48 0 3 70 41 188 
1121 2304 864 128 48 0 2 165 192 
1122 2432 864 128 48 0 3 71 189 192 
1123 2304 912 128 48 0 3 37 44 188 
1124 2432 912 128 48 0 4 100 71 44 189 
1133 2560 864 128 48 0 2 192 189 
1134 2688 864 128 48 0 4 192 191 189 72 
1135 2560 912 128 48 0 2 189 101 
1136 2688 912 128 48 0 3 191 189 72 
1137 2816 864 128 48 0 2 192 190 
1138 2944 864 128 48 0 3 192 190 180 
1139 2816 912 128 48 0 2 190 104 
1140 2944 912 128 48 0 3 190 180 105 
1141 2048 960 128 48 0 5 99 43 41 42 166 
1142 2176 960 128 48 0 2 41 188 
1143 2048 1008 128 48 0 0 
1144 2176 1008 128 48 0 1 109 
1145 2304 960 128 48 0 3 44 37 188 
1146 2432 960 128 48 0 5 100 44 38 39 189 
1147 2304 1008 128 48 0 0 
1148 2432 1008 128 48 0 1 39 
1157 2560 960 128 48 0 4 101 40 63 189 
1158 2688 960 128 48 0 3 40 56 189 
1159 2560 1008 128 48 0 2 40 63 
1160 2688 1008 128 48 0 3 178 40 56 
1161 2816 960 128 48 0 2 64 190 
1162 2944 960 128 48 0 4 180 57 64 190 
1163 2816 1008 128 48 0 2 178 64 
1164 2944 1008 128 48 0 3 181 57 64 
0 0 0 0 0 0 0