0 0 0 1536 384 1 0 
1 0 0 768 192 0 4 2 1 0 7 
2 768 0 768 192 1 0 
3 0 192 768 192 0 0 
4 768 192 768 192 0 0 
9 768 0 384 96 0 3 7 3 4 
10 1152 0 384 96 0 3 7 6 5 
11 768 96 384 96 0 2 3 4 
12 1152 96 384 96 0 2 6 5 
0 0 0 0 0 0 0