6 24 8 4 32 48
0 1 1 1 1 1 0 0 0 1 1 1 1 1 0 0 0 0 0 0 2 3 3 4 
5 6 6 6 6 6 7 7 5 6 6 6 6 6 7 7 7 7 7 7 8 9 9 10 
11 12 11 11 11 11 6 6 11 12 11 11 11 11 6 6 6 6 13 13 14 15 16 17 
12 18 12 12 12 12 12 12 12 18 12 12 12 12 12 12 12 12 18 19 20 21 16 10 
22 23 24 22 22 24 22 24 22 23 24 22 22 24 22 24 24 25 23 26 27 28 29 30 
31 31 31 31 31 31 31 31 31 31 31 31 31 31 31 31 31 31 31 31 31 31 31 31 