0 0 0 5632 768 1 0 
1 0 0 2816 384 0 3 43 154 170 
2 2816 0 2816 384 1 0 
3 0 384 2816 384 1 0 
4 2816 384 2816 384 1 0 
9 2816 0 1408 192 1 0 
10 4224 0 1408 192 0 1 156 
11 2816 192 1408 192 1 0 
12 4224 192 1408 192 0 3 49 156 164 
13 0 384 1408 192 1 0 
14 1408 384 1408 192 1 0 
15 0 576 1408 192 0 2 65 103 
16 1408 576 1408 192 1 0 
17 2816 384 1408 192 1 0 
18 4224 384 1408 192 1 0 
19 2816 576 1408 192 1 0 
20 4224 576 1408 192 1 0 
37 2816 0 704 96 1 0 
38 3520 0 704 96 1 0 
39 2816 96 704 96 0 3 154 155 172 
40 3520 96 704 96 1 0 
45 2816 192 704 96 1 0 
46 3520 192 704 96 1 0 
47 2816 288 704 96 1 0 
48 3520 288 704 96 1 0 
53 0 384 704 96 1 0 
54 704 384 704 96 1 0 
55 0 480 704 96 1 0 
56 704 480 704 96 1 0 
57 1408 384 704 96 0 3 154 158 169 
58 2112 384 704 96 1 0 
59 1408 480 704 96 1 0 
60 2112 480 704 96 1 0 
65 1408 576 704 96 1 0 
66 2112 576 704 96 0 3 12 54 170 
67 1408 672 704 96 0 2 104 105 
68 2112 672 704 96 0 1 114 
69 2816 384 704 96 1 0 
70 3520 384 704 96 1 0 
71 2816 480 704 96 1 0 
72 3520 480 704 96 1 0 
73 4224 384 704 96 1 0 
74 4928 384 704 96 1 0 
75 4224 480 704 96 1 0 
76 4928 480 704 96 1 0 
77 2816 576 704 96 0 4 64 118 159 170 
78 3520 576 704 96 1 0 
79 2816 672 704 96 1 0 
80 3520 672 704 96 1 0 
81 4224 576 704 96 1 0 
82 4928 576 704 96 0 2 62 88 
83 4224 672 704 96 0 0 
84 4928 672 704 96 0 1 178 
149 2816 0 352 48 0 4 148 142 154 172 
150 3168 0 352 48 1 0 
151 2816 48 352 48 0 4 148 142 154 172 
152 3168 48 352 48 1 0 
153 3520 0 352 48 1 0 
154 3872 0 352 48 1 0 
155 3520 48 352 48 1 0 
156 3872 48 352 48 1 0 
161 3520 96 352 48 0 4 172 156 155 174 
162 3872 96 352 48 0 3 156 174 175 
163 3520 144 352 48 1 0 
164 3872 144 352 48 0 4 156 20 46 174 
181 2816 192 352 48 0 2 154 172 
182 3168 192 352 48 1 0 
183 2816 240 352 48 0 2 121 154 
184 3168 240 352 48 1 0 
185 3520 192 352 48 1 0 
186 3872 192 352 48 1 0 
187 3520 240 352 48 1 0 
188 3872 240 352 48 0 4 37 21 19 156 
189 2816 288 352 48 0 2 154 170 
190 3168 288 352 48 1 0 
191 2816 336 352 48 0 2 154 170 
192 3168 336 352 48 1 0 
193 3520 288 352 48 1 0 
194 3872 288 352 48 0 2 37 156 
195 3520 336 352 48 1 0 
196 3872 336 352 48 0 2 47 156 
213 0 384 352 48 0 1 154 
214 352 384 352 48 0 4 70 69 68 154 
215 0 432 352 48 0 1 93 
216 352 432 352 48 1 0 
217 704 384 352 48 0 1 154 
218 1056 384 352 48 1 0 
219 704 432 352 48 0 0 
220 1056 432 352 48 1 0 
221 0 480 352 48 0 3 97 94 93 
222 352 480 352 48 0 3 96 95 98 
223 0 528 352 48 0 2 97 94 
224 352 528 352 48 0 1 96 
225 704 480 352 48 0 2 99 100 
226 1056 480 352 48 1 0 
227 704 528 352 48 0 1 99 
228 1056 528 352 48 1 0 
233 2112 384 352 48 0 3 73 74 154 
234 2464 384 352 48 0 4 43 9 154 170 
235 2112 432 352 48 0 2 73 74 
236 2464 432 352 48 0 4 9 8 7 170 
237 1408 480 352 48 1 0 
238 1760 480 352 48 1 0 
239 1408 528 352 48 1 0 
240 1760 528 352 48 1 0 
241 2112 480 352 48 0 2 109 110 
242 2464 480 352 48 1 0 
243 2112 528 352 48 0 2 109 110 
244 2464 528 352 48 1 0 
261 1408 576 352 48 1 0 
262 1760 576 352 48 1 0 
263 1408 624 352 48 0 1 66 
264 1760 624 352 48 0 2 66 106 
277 2816 384 352 48 1 0 
278 3168 384 352 48 1 0 
279 2816 432 352 48 1 0 
280 3168 432 352 48 0 3 14 13 170 
281 3520 384 352 48 1 0 
282 3872 384 352 48 0 4 24 47 156 171 
283 3520 432 352 48 1 0 
284 3872 432 352 48 1 0 
285 2816 480 352 48 0 3 113 159 170 
286 3168 480 352 48 1 0 
287 2816 528 352 48 0 2 159 170 
288 3168 528 352 48 0 4 55 35 160 170 
289 3520 480 352 48 1 0 
290 3872 480 352 48 1 0 
291 3520 528 352 48 1 0 
292 3872 528 352 48 1 0 
293 4224 384 352 48 0 3 156 164 171 
294 4576 384 352 48 1 0 
295 4224 432 352 48 0 3 135 164 171 
296 4576 432 352 48 1 0 
297 4928 384 352 48 0 2 156 87 
298 5280 384 352 48 0 1 156 
299 4928 432 352 48 0 1 87 
300 5280 432 352 48 0 4 166 50 32 167 
301 4224 480 352 48 1 0 
302 4576 480 352 48 1 0 
303 4224 528 352 48 1 0 
304 4576 528 352 48 1 0 
305 4928 480 352 48 0 3 138 139 140 
306 5280 480 352 48 1 0 
307 4928 528 352 48 0 0 
308 5280 528 352 48 0 4 61 33 141 165 
313 3520 576 352 48 0 3 129 79 168 
314 3872 576 352 48 0 2 163 171 
315 3520 624 352 48 0 3 129 128 79 
316 3872 624 352 48 0 2 63 82 
317 2816 672 352 48 0 3 179 115 64 
318 3168 672 352 48 0 2 117 116 
319 2816 720 352 48 0 1 179 
320 3168 720 352 48 0 0 
321 3520 672 352 48 0 2 128 78 
322 3872 672 352 48 1 0 
323 3520 720 352 48 0 0 
324 3872 720 352 48 0 1 180 
325 4224 576 352 48 1 0 
326 4576 576 352 48 0 2 84 133 
327 4224 624 352 48 0 1 132 
328 4576 624 352 48 0 1 133 
601 3168 0 176 24 0 4 142 143 154 172 
602 3344 0 176 24 0 2 144 172 
603 3168 24 176 24 0 6 142 143 148 149 154 172 
604 3344 24 176 24 0 3 144 150 172 
609 3168 48 176 24 0 6 142 143 148 149 154 172 
610 3344 48 176 24 0 3 144 150 172 
611 3168 72 176 24 0 2 154 172 
612 3344 72 176 24 0 1 172 
613 3520 0 176 24 0 2 145 172 
614 3696 0 176 24 0 3 147 146 156 
615 3520 24 176 24 0 6 90 89 145 150 151 172 
616 3696 24 176 24 0 7 147 146 90 152 153 156 174 
617 3872 0 176 24 0 2 156 147 
618 4048 0 176 24 0 1 156 
619 3872 24 176 24 0 7 156 153 147 91 92 174 176 
620 4048 24 176 24 0 4 156 92 174 176 
621 3520 48 176 24 0 6 90 89 145 150 151 172 
622 3696 48 176 24 0 7 147 146 90 152 153 156 174 
623 3520 72 176 24 0 1 172 
624 3696 72 176 24 0 2 156 174 
625 3872 48 176 24 0 7 156 153 147 91 92 174 176 
626 4048 48 176 24 0 4 156 92 174 176 
627 3872 72 176 24 0 3 156 174 176 
628 4048 72 176 24 0 4 156 174 175 176 
653 3520 144 176 24 0 3 173 155 172 
654 3696 144 176 24 0 3 174 155 156 
655 3520 168 176 24 0 3 173 155 172 
656 3696 168 176 24 0 3 174 155 156 
729 3168 192 176 24 0 3 172 155 154 
730 3344 192 176 24 0 2 172 155 
731 3168 216 176 24 0 4 177 155 154 45 
732 3344 216 176 24 0 2 177 155 
737 3168 240 176 24 0 5 154 17 45 155 177 
738 3344 240 176 24 0 3 123 155 177 
739 3168 264 176 24 0 5 154 16 17 155 177 
740 3344 264 176 24 0 3 123 155 177 
741 3520 192 176 24 0 3 173 172 155 
742 3696 192 176 24 0 3 174 156 155 
743 3520 216 176 24 0 1 155 
744 3696 216 176 24 0 2 156 155 
745 3872 192 176 24 0 4 174 156 20 46 
746 4048 192 176 24 0 2 174 156 
747 3872 216 176 24 0 3 156 19 20 
748 4048 216 176 24 0 1 156 
749 3520 240 176 24 0 1 155 
750 3696 240 176 24 0 2 155 156 
751 3520 264 176 24 0 3 155 125 124 
752 3696 264 176 24 0 5 155 126 125 37 156 
761 3168 288 176 24 0 4 155 16 122 154 
762 3344 288 176 24 0 1 155 
763 3168 312 176 24 0 6 155 16 18 122 154 170 
764 3344 312 176 24 0 2 155 170 
769 3168 336 176 24 0 4 170 155 18 154 
770 3344 336 176 24 0 2 170 155 
771 3168 360 176 24 0 4 170 155 36 154 
772 3344 360 176 24 0 2 170 155 
773 3520 288 176 24 0 3 125 124 155 
774 3696 288 176 24 0 5 126 125 37 155 156 
775 3520 312 176 24 0 1 155 
776 3696 312 176 24 0 4 22 37 155 156 
781 3520 336 176 24 0 1 155 
782 3696 336 176 24 0 3 156 155 22 
783 3520 360 176 24 0 2 155 44 
784 3696 360 176 24 0 3 156 155 38 
865 352 432 176 24 0 1 68 
866 528 432 176 24 0 3 68 69 70 
867 352 456 176 24 0 2 68 95 
868 528 456 176 24 0 4 98 68 69 70 
873 1056 384 176 24 0 2 154 40 
874 1232 384 176 24 0 2 154 40 
875 1056 408 176 24 0 4 154 72 40 71 
876 1232 408 176 24 0 3 154 40 0 
881 1056 432 176 24 0 2 72 71 
882 1232 432 176 24 0 2 1 0 
883 1056 456 176 24 0 2 72 71 
884 1232 456 176 24 0 2 2 1 
905 1056 480 176 24 0 0 
906 1232 480 176 24 0 2 2 157 
907 1056 504 176 24 0 2 101 102 
908 1232 504 176 24 0 5 34 2 51 65 157 
913 1056 528 176 24 0 2 102 101 
914 1232 528 176 24 0 4 34 51 65 157 
915 1056 552 176 24 0 0 
916 1232 552 176 24 0 2 65 157 
949 1408 480 176 24 0 2 157 169 
950 1584 480 176 24 0 2 107 169 
951 1408 504 176 24 0 5 157 65 51 41 169 
952 1584 504 176 24 0 2 107 169 
953 1760 480 176 24 0 3 169 158 108 
954 1936 480 176 24 0 2 158 108 
955 1760 504 176 24 0 4 169 158 108 42 
956 1936 504 176 24 0 3 158 108 67 
957 1408 528 176 24 0 6 51 3 41 65 157 169 
958 1584 528 176 24 0 1 169 
959 1408 552 176 24 0 6 52 4 3 65 157 169 
960 1584 552 176 24 0 1 169 
961 1760 528 176 24 0 4 42 6 158 169 
962 1936 528 176 24 0 2 67 158 
963 1760 552 176 24 0 5 53 6 5 158 169 
964 1936 552 176 24 0 2 67 158 
969 2464 480 176 24 0 0 
970 2640 480 176 24 0 3 170 112 8 
971 2464 504 176 24 0 1 111 
972 2640 504 176 24 0 4 170 112 8 10 
977 2464 528 176 24 0 1 111 
978 2640 528 176 24 0 3 10 11 170 
979 2464 552 176 24 0 0 
980 2640 552 176 24 0 4 11 12 54 170 
1045 1408 576 176 24 0 4 169 52 4 65 
1046 1584 576 176 24 0 2 169 66 
1047 1408 600 176 24 0 3 169 52 4 
1048 1584 600 176 24 0 2 169 66 
1049 1760 576 176 24 0 4 66 53 5 169 
1050 1936 576 176 24 0 1 67 
1051 1760 600 176 24 0 5 106 66 53 5 169 
1052 1936 600 176 24 0 1 106 
1109 2816 384 176 24 0 2 154 170 
1110 2992 384 176 24 0 3 154 56 170 
1111 2816 408 176 24 0 5 154 77 76 75 170 
1112 2992 408 176 24 0 4 154 76 56 170 
1113 3168 384 176 24 0 5 170 155 154 36 56 
1114 3344 384 176 24 0 2 170 155 
1115 3168 408 176 24 0 5 170 155 154 36 56 
1116 3344 408 176 24 0 2 170 155 
1117 2816 432 176 24 0 4 170 77 76 75 
1118 2992 432 176 24 0 2 170 76 
1119 2816 456 176 24 0 4 170 77 76 75 
1120 2992 456 176 24 0 3 170 159 76 
1125 3520 384 176 24 0 2 155 44 
1126 3696 384 176 24 0 4 155 57 38 156 
1127 3520 408 176 24 0 4 155 44 15 161 
1128 3696 408 176 24 0 5 155 57 38 156 161 
1133 3520 432 176 24 0 3 161 14 15 
1134 3696 432 176 24 0 1 161 
1135 3520 456 176 24 0 3 168 161 14 
1136 3696 456 176 24 0 3 168 161 80 
1137 3872 432 176 24 0 3 171 23 24 
1138 4048 432 176 24 0 1 171 
1139 3872 456 176 24 0 4 171 127 23 25 
1140 4048 456 176 24 0 1 171 
1145 3168 480 176 24 0 2 120 170 
1146 3344 480 176 24 0 3 160 13 170 
1147 3168 504 176 24 0 2 120 170 
1148 3344 504 176 24 0 5 160 13 35 55 170 
1157 3520 480 176 24 0 2 161 168 
1158 3696 480 176 24 0 4 162 161 80 168 
1159 3520 504 176 24 0 3 161 119 168 
1160 3696 504 176 24 0 4 162 161 58 168 
1161 3872 480 176 24 0 4 162 127 25 171 
1162 4048 480 176 24 0 2 163 171 
1163 3872 504 176 24 0 5 162 25 39 58 171 
1164 4048 504 176 24 0 2 163 171 
1165 3520 528 176 24 0 3 168 161 119 
1166 3696 528 176 24 0 4 168 162 161 58 
1167 3520 552 176 24 0 2 168 161 
1168 3696 552 176 24 0 3 168 162 161 
1169 3872 528 176 24 0 4 162 39 58 171 
1170 4048 528 176 24 0 3 163 81 171 
1171 3872 552 176 24 0 2 162 171 
1172 4048 552 176 24 0 3 163 81 171 
1177 4576 384 176 24 0 2 156 164 
1178 4752 384 176 24 0 2 156 49 
1179 4576 408 176 24 0 4 156 86 85 164 
1180 4752 408 176 24 0 4 156 31 49 85 
1185 4576 432 176 24 0 3 86 85 164 
1186 4752 432 176 24 0 3 30 31 85 
1187 4576 456 176 24 0 4 86 29 85 164 
1188 4752 456 176 24 0 3 30 29 85 
1205 4224 480 176 24 0 3 164 134 171 
1206 4400 480 176 24 0 3 164 136 135 
1207 4224 504 176 24 0 4 164 134 48 171 
1208 4400 504 176 24 0 4 164 136 135 48 
1209 4576 480 176 24 0 3 136 29 164 
1210 4752 480 176 24 0 2 29 138 
1211 4576 504 176 24 0 5 136 60 29 28 164 
1212 4752 504 176 24 0 3 137 29 138 
1213 4224 528 176 24 0 4 26 48 164 171 
1214 4400 528 176 24 0 2 48 164 
1215 4224 552 176 24 0 5 59 27 26 164 171 
1216 4400 552 176 24 0 2 83 164 
1217 4576 528 176 24 0 3 164 60 28 
1218 4752 528 176 24 0 1 137 
1219 4576 552 176 24 0 2 164 84 
1220 4752 552 176 24 0 0 
1225 5280 480 176 24 0 1 50 
1226 5456 480 176 24 0 5 165 32 50 166 167 
1227 5280 504 176 24 0 0 
1228 5456 504 176 24 0 5 165 32 33 61 166 
1289 3872 672 176 24 0 1 130 
1290 4048 672 176 24 0 3 131 82 63 
1291 3872 696 176 24 0 2 180 130 
1292 4048 696 176 24 0 3 180 131 63 
1301 4224 576 176 24 0 3 171 59 27 
1302 4400 576 176 24 0 1 83 
1303 4224 600 176 24 0 3 171 59 27 
1304 4400 600 176 24 0 2 83 132 
0 0 0 0 0 0 0